...............................................................
...............................................................
...............................................................
......***********..............................................
....***************.............^&&^...........................
....***************.............^kk^...........................
....********@******.............^kk^...........................
....***********************************........................
....***********************************........................
.....**********************************........................
......**********...............................................
.......********................................................
...............................................................
...............................................................
...............................................................
...............................................................
...............................................................
...............................................................